1111111111
1000C01001
101011E101
1010001001
1011001001
100P0C0001
1001111001
1111111111
