1111111111
1000C00E01
100C00P001
100E000001
1111111111
