1111111111111111
1P000000000000E1
11100011X0111001
1CX000110001C1C1
1000000000000001
1111111111111111