11111111111111111111111111111111111111111111111111
1P00001100010000000000C1000000000000000000000010E1
10000000000100000000001001101100000110000000000011
101000X0000000000X00000000000000000000000000000001
1C10000001111100000000111111C00000X110001110000011
11111111111111111111111111111111111111111111111111