1111111111111
1P00000X000C1
1011101011101
10100X0000101
1000011111101
1010100X10101
100X00C000X01
10101X0X10101
1011110011101
10100X0X00101
1011101011101
1C00000X000E1
1111111111111
