11111111111111111111111111111111111111111111111111111111111111
1P00000000000000000000000000000000000E111111111111111111111111
10001111111111111111111111111111111000111111111111111111111111
10001100000000000000000000000000011000111111111111111111111111
10001101111111111111111111111110111000111111111111111111111111
10001100000000000000000000000010111000111111111111111111111111
10001101111111111111111111111010111000111111111111111111111111
10001101111111111111111111111010111000111111111111111111111111
10001101111111111111111111111010111000111111111111111111111111
10000000000000000000000000000000111000111111111111111111111111
10111111111111111111111111111110111000111111111111111111111111
1000000C000000000000000000000000111000111111111111111111111111
10101111111111111111111111111010111000111111111111111111111111
100000000000000000000000C0000000111000111111111111111111111111
10111111111111111111111111111110111000111111111111111111111111
10111111111111111111111111111110111000111111111111111111111111
10111111111111111111111111111110111000111111111111111111111111
10000000000000000000000000000000111000111111111111111111111111
1C000000000000000000000000000000000001111111111111111111111111
1C000000000000000000000000000000000001111111111111111111111111
1C000000000000000000000000000000000001111111111111111111111111
1C000000000000000000000000000000000001111111111111111111111111
1C000000000000000000000000000000000001111111111111111111111111
1C000000000000000000000000000000000001111111111111111111111111
1C000000000000000000000000000000000001111111111111111111111111
1C000000000000000000000000000000000001111111111111111111111111
1C000000000000000000000000000000000001111111111111111111111111
1C000000000000000000000000000000000001111111111111111111111111
1C000000000000000000000000000000000001111111111111111111111111
1C000000000000000000000000000000000001111111111111111111111111
11111111111111111111111111111111111111111111111111111111111111
