1111111111111
10010000000E1
1000010000001
1PPC010000001
1111111111111