1111111111111
10010000000E1
1000010000001
1PC01000000E1
1111111111111