1111111111111
10010000000E1
1001010000001
1P1C110000001
1111111111111