1111111111111
1001000E001
1000010000001
1P0C01000001
111111