1111111111111
10010000000E0
1000010000001
1P0C010000001
1111111111111