1111111111111111111111111
10000000000000000000000E1
1011111011111110111111011
10000C00000000000000C0011
1000000000011110000000001
1111001111111111111101111
10000C000000P1000000C0011
1011111011111110111111011
1000000000000000000000001
1011111011111110111111011
10C00000000000000000C0011
1111111111111111111111111