1111111111111111111111111
1000X000000000000000000E1
1011101011111110111111011
100010C0000000000X00C0011
1000010000011110000000001
1111001111111111111101111
10000C000000P1000000C0011
1011111011111110111111011
1000000000000000000000001
1011111011111110111111011
10C000000000X0000000C0011
1111111111111111111111111